0000000000000000000000000000000000000000
0000000000000000000000000000000000000000
00000000000000000qqqqqq0000qqqqqqq000000
0000000000000000000000qq00qq000000qq0000
00000000000000000000000q00q000000000q000
00000qqqqqqqqqqqq000$0qq00q000000000q000
00000q00000000000000$0q000q000070000q000
00000qq0000000000007$0q000q000070000q000
070000q0000000000007$0q000q200070000q000
070000q0000000000007$0q000q000070000q000
07000q33000000000007$0q000qqq0070000q000
07000qq333000000q007$0q00000q0070000q000
070000q030000000q0070$q00000q0070000q000
070000q033300000q0070$q00000q0000000q000
070000q0003330000q0700q00000q0000000q000
070000q0003300000q000$q00000q0000000q000
070000q3333000000q000$q00000q0000000q000
070000q0000000000q000$q00000q00000000q00
070000000000000000q0$$q00000000000000q00
070000000000000000q0$0q0B000000000000q00
000000000000000000q0$0q0000000000qqq0q00
00000qqqqqqqqqqqqq0000qqqqqqqqqqq00qqq00
0000000000000000000000000000000000000000
0000000000000000000000000000000000000000
