1111111111111111111111111111111111111111
0000000000000000000000000000003000000001
0003000000000000000000000000000000300001
1111111111111111111111111111111111111001
0000000000000000000000000000000000001001
0000000000000000000000000000000000001001
0011111111111111111111110011111111001001
0000100000000000000000010000000001001001
0000100000000000000000010000000001001001
1100100111111111111110011111111001001001
0000100100000000000010010000000001001001
0000100100000000000010010000000001001001
0011100100111111110010010011111111001001
0000100100000000010000010000000001001001
0000100100000000010000010000000001001001
1100100111111000011111111111111001001001
0000100000001000000000010000000001001001
0000100000001110000000010000000000000001
0011111111000011110000010000000000030001
0000000000000000011110011111111111118111
0000000000000000000010000000000000000002
0000000000000000000010000000000000000002
1111111111111111111111111111111111111111
1111111111111111111111111111111111111111