0000000000000000000000000000000000000000
3333000000000000000000000000000000000000
0003000000000000000000000000000000000000
0000000000000020000000000000000000000000
0000000000000002000000030000000000000000
0000000000300002200000030000000000000000
0000000000300000200000300000000000000000
0000000000030000000003000000000000000000
0000000003333300303003000000000000000000
0000000030003000000330000000000000000000
0000000300000300000B30000000000000000000
000000030000003000BB30300000000000000000
000000300000000330BBB0030000000000000000
000000300000000033303BBB0000000000000000
00000300000000003033300B0000000000000000
0000033333333003300003B00000000000000000
00000000000003330BBBB0000000000000000000
0000000000000000BBBB00000000000000000000
0000000000000000B03000000000000000000000
0000000000000000000000000000000000000000
0000000000000000000000000000000000000000
0000000000000000077777700000000000000000
0000000000000000000000000000000000000000
0000000000000000000000000000000000000000
