1111111111111111111111111111111111111111
z00000550000000w000000000000000000000001
z00000530000000w000000000000000000000001
1r00000w000000Hw0000000lw33wwwww33wwwww1
1r00000w00wwwwwwr000000wwww555wwwwww5551
1000000w00000000000000000000500000005051
100000lw00000070000000000000500000000051
100000lwwwwwwwwwwwwwwr000000000000000001
1000000w50000000000000000000000000000001
1507000w00000000000000000000000000000001
1wwwww0w$0000w33wwrw0lw3w000000000000001
1r00000wwwwwwwwwwwwwwwwwwwwwwww00000www1
1r00000w55555000500050000000000000000001
1r00000w55500000500050000000000000000001
1r0000lw55000000500000003wwwwwwwww000001
1r00000w5000000000000000w000000000000001
1r00000w5000000000000000w000000000000001
1r00700w5000000000000000w000700000070001
1r00wwww00000000wwwwwwwwwwwwwwwwww0wwww1
1r00000w0000000000ww0000w000000lw5000001
1000000400000000004000000000000lw0000001
1000000000000000000000000000000lw0000002
100000000000000000000000700070Hlwr0$$00"
1111111111111111111111111111111111111111