1111111111111111111111111111111111111111
z000000000000000000000000000000000000051
z000000007000000000070000000000700000001
11111111111111111111111111111111111r00l1
1550000000000000000000000000000015000001
1000000000000000000000000000H00015000001
100001100l111111111111111111111111000001
1000l10000000001000000000000000001000001
1000010000007001$00000070000000000000001
1000010000wwwwwwwwwwwwwwwwwwww0000000001
1r0001000000050000050000050000www0000001
1000010000000500000500000500000210000001
1000010000000000000000000000000210000001
1000l100007000070000700007000wwww0000001
100001wwwwwwwwwwwwwwwwwwwwwwwww440000001
1000010000000000000000000000000000000001
1500010000000000000000000000000000070001
100001111111111111111111111111000wwwwww1
1000000000000000000000000000510000005551
10000000000000000000000000H0010000000051
10000wwwwwwwwwwwwwwwwwwwwwwwwwwww0000001
1000000000000000000000000000000000000001
1000000000000000000000000000000000000051
1111111111111111111111111111111111111111