1111111111111111111111111111111111111111
0000000000000000000007000000000000000001
0000000000000000000000000000000000000001
1111111111111111111111111111111111111001
5000000000000000000000000000000000001001
0000000000000000000000000000000000001001
0010011111111111111111111111111111001001
0010010000000001000000000000000001001001
0010010000000001000000000000000000001001
0010010011111111111111111111111000001001
0010010011111111111111111111111001001001
0010010000000000000000000000288008008001
0010010000000000000000000000211118008001
0010010011111001111111111111111001000001
0010010011111001111111111111111000000001
0010010000000000000000000000000000000001
0010010000000000000000000000000000001001
0010011111111111111111111111110011001001
0010000000000000000000000000010000001001
0015000000000000000000000000010000001001
0011111111111111111111111111111111111001
0000000000000000700000000000000000000001
0000000000000000000000000000000000000051
1111111111111111111111111111111111111111