1111111111111111111111111111111111111111
0000000000000000000000000000000000000051
0000000007000000000070000000000700000001
11111111111111111111111111111111111r00l1
1550000000000000000000000000000015000001
1000000000000000000000000000H00015000001
100001100l111111111111111111111111000001
1000l10000000001000000000000000001000001
1000010000007001$00000070000000000000001
1000010000wqwqwqwqwqwqwqwqwqwq0000000001
1r0001000000050000050000050000wqq0000001
1000010000000500000500000500000210000001
1000010000000000000000000000000210000001
1000l100007000070000700007000qwwq0000001
100001wqwqwwqwwqwqwqwqwqwqwqwqw440000001
1000010000000000000000000000000000000001
1500010000000000000000000000000000070001
100001111111111111111111111111000wqwqwq1
1000000000000000000000000000510000005551
10000000000000000000000000H0010000000051
10000wqwqwwqwqwqwqwqwqwqwqwqwqwqw0000001
1000000000000000000000000000000000000001
1000000000000000000000000000000000000051
1111111111111111111111111111111111111111