1111111111111111111111111111111111111111
0000000011100000000000000000000000000002
1000000011100000000000000000000000000002
1000000011100000000110000000011000000011
1110000011100000000110000000011000000011
1110000111111111111111111111111000011111
1110000111111111111111111111111000011111
1110000111100000000000110000000000000011
1100000111100000111110000011111000001111
1000000011100000001110000000111000000011
1010000011100000000110000000011000000001
0000000000000000000000000000000000000001
1111100000001111111111111111111100001111
0011000000001100000000110000000000000001
1001000111100000111110000011111000001111
1000000011100000001110000000111000000011
1010000001100000000110000000011000000001
1111000011111111111111111111111111100011
1111000000000111111111111111111111100011
1111000000000000000000110000000000000001
1111001111100000000000000000111000000011
1111000011100000001110000000111000000011
1111111111111111111111111111111111111111
1111111111111111111111111111111111111111