1111111ww1111111111wwwwwwwwwwwwwwwwwwww1
0000000000000440000000000000000000000051
0000000000000000000000000000000000000001
1500000000000000000000007000000000000001
1qqqqqqqqq33qqqqqqqqqqqqqqqqqqqqqqqr00l1
1500000005ww5000000500000500005555q00001
1000000000000000000500000500000055q00001
1H00000000000000000000000500000005q00001
1000000000000000000000000000000000q00001
1000000000000333333000000000000000400001
150000700000lqqqqqqr00007000000000000001
1wwwwwwwwwwwwwwwwwwwwwwwwwwwwwr000000001
1000000000000000000000000000000000000001
1000000000000000000000000000000000000001
1000000000000000000000000000000700000051
1000000000000000003wwwwwwwwwwwwwwwwwwww1
100000000000000000qqqqqqqq44qqqqqq4qqq41
100000000000000000q555555500555555055551
100070007000000003q500000000000000000001
1qqqqqqqq00q00003q500000000B000000000001
15040000000q0000q50000000000000000000051
10000000000q0000000000000000000000000002
1$000030000q0000070000000000000000000002
1111111111111111111111111111111111111111