1111111ww1111111111wwwwwwwwwwwwwwwwwwww1
0000000000000440000000000000000000000051
0000000000000000000000000000000000000001
1500000000000000000000007000000000000001
1wwwwwwwww33wwwwwwwwwwwwwwwwwwwwwwwr00l1
1500000005ww5000000500000500005555w00001
1000000000000000000500000500000055w00001
1H00000000000000000000000500000005w00001
1000000000000000000000000000000000w00001
1000000000000333333000000000000000400001
150000700000lwwwwwwr00007000000000000001
1wwwwwwwwwwwwwwwwwwwwwwwwwwwwwr000000001
1000000000000000000000000000000000000001
1000000000000000000000000000000000000001
1000000000000000000000000000000700000051
1000000000000000003wwwwwwwwwwwwwwwwwwww1
100000000000000000wwwwwwww44wwwwww4www41
100000000000000000w555555500555555005551
100070007000000003w500000000000000000001
1wwwwwwww00w00003w500000000B000000000001
15040000000w0000w50000000000000000000051
100x0000000w0000000000000000000000000002
1$000030000w000007000000000000000000000"
1111111111111111111111111111111111111111