0000111111111111111111111111111111111111
0001000000001100000000110000100011000000
1001000000000100000000000011111000001111
1000000011100000001110000000111000000011
1010000001101000000110000000011010000001
1110011111111111111111111111111110011111
1110011111111111111111111111111110011111
0010000000001100000000110000000000000001
1000001111100100111110010011111001001111
1000000011100000001110000000111000000011
1010000001101000000110100000011010000001
0000000000000000000000000000000000000001
1111100000001111111111111111111100001111
0011000000001100000000110000000011000001
1001000111100100111110010011111001001111
1000000011100000001110000000111000000011
1010000001101000000110100000011010000001
1111000011111111111111111111111111100011
1111110000011111111111111111111111100011
0011000000001100000000110000000011000001
1001001111100100111110010011111001001111
1000000011100000001110000000111000000011
1010000001101000000110100000011010000001
1111111111111111111111111111111111111111