1111111111111111111111111111111111111111
000000550000000q000000000000000000000001
000000530000000w000000000000000000000001
1r00000w000000Hq0000000lw33wwwww33wwwww1
1r00000w00qwqwqwr000000wqwq555wwqwwq5551
1000000w00000000000000000000500000005051
100000lw00000070000000000000500000000051
100000lwqwqwqwqwqwqwqr000000000000000001
1000000w50000000000000000000000000000001
1507000w00000000000000000000000000000001
1wwwww0w$0000w33wwrw0lw3w000000000000001
1r00000wqqqqqqqqqqqqqqqqqqqqqqq00000www1
1r00000w55555000500050000000000000000001
1r00000w55500000500050000000000000000001
1r0000lw55000000500000003qqwwqqwww000001
1r00000w5000000000000000q000000000000001
1r00000w5000000000000000w000000000000001
1r00700w5000000000000000q000700000070001
1r00qqqw00000000wwwwwwwwwwwwwwwwww0wwww1
1r00000w0000000000q0000q5000000lq5000001
1000000400000000004000000000000lq0000001
1000000000000000000000000000000lq0000002
100000000000000000000000700070Hlqr0$$002
1111111111111111111111111111111111111111