1111111111111111111111111111111111111111
0000000001000000011111111111111111111002
0000000001000000011111111001100110011002
1111111001001110000100000000000000000001
1000000001001110000111000000000000000001
1000000001001111100001000011111111111111
1001111001000000100001110000000000000001
1000000001000000111000010000000000000001
1000000001001000001000011111111111001001
1111100111001000001110000000000000001001
1000000001001111000010000000000000001001
1000000001001001000011100001110011111001
1001001001001001110000100001110000001001
1001001001000000010000111000010000001001
1001001001000000011100001000011100001001
1000000001001110000100001110000100001001
1000000001001110000111000010000111111001
1110011001001111100001000011100001100001
1000000001001000100001110000100001100001
1000000000001000111000010000111000000111
1001111000001000001000011100001000000111
1000000001001000001110000000001110011101
1000000001001000000010000000000010010001
1111111111111111111111111111111111111111