1111111111111111111111111111111111111111
0000000000000000000000000000000000000001
0000000000000000000000000000000000000001
1111111111111111111111111111111111111001
0000000000000000000000000000000000001001
0000000000000000000000000000000000001001
0010011111111111111111111111111111001001
0010010000000001000000000000000001001001
0010010000000001000000000000000000001001
0010010011111111111111111111111000001001
0010010011111111111111111111111001001001
0010010000000000000000000000211001001001
0010010000000000000000000000211111001001
0010010011111001111111111111111001001001
0010010011111001111111111111111001001001
0010010000000000000000000000000001001001
0010010000000000000000000000000001001001
0010011111111111111111111111110011001001
0010000000000000000000000000010000001001
0010000000000000000000000000010000001001
0011111111111111111111111111111111111001
0000000000000000000000000000000000000001
0000000000000000000000000000000000000001
1111111111111111111111111111111111111111